1111111111100001111111111111111
1111111111100001111111111111111
111111111110X001111111111111111
1111111111000011111111111111111
1111111110000111111111111111111
1111111000011111111111111111111
111110X001111111111111111111111
1111100001111111111111111111111
1110000111111111111111111111111
1111000011111111111111111111111
1111110000111111111111111111111
1111111000011111111111111111111
1111111110000111111111111111111
1111111111100X01111111111111111
11111111111111ABCD1111111111111