111111111110001111111111111111\
111111111110001111111111111111\
111111111110001111111111111111\
111111111100011111111111111111\
111111111000111111111111111111\
111111100011111111111111111111\
111110001111111111111111111111\
111110001111111111111111111111\
111000111111111111111111111111\
111100011111111111111111111111\
111111000111111111111111111111\
111111100011111111111111111111\
111111111000111111111111111111\
111111111110001111111111111111\
111111111111110001111111111111}
